1111111
1P10001
1CCCCC1
10000E1
1111111